| | | |*| | |*|*| | | |*| | |*| |*|*| |*|*| |*| |*|*|*|*|*|*|*|*| | |*| |*| | |*|*|*|*| |*|*|*|*|*|*|
|*| | | | | |*| |*|*| | |*| |*| | | | | |*| |*|*| | | | | | | |*| | | | | |*| | | | | | | | | | | |*|
|*| |*| |*| | | | | | | | | |*|*|*| |*| | | | | | | |*| | |*| | | | |*| |*|*|*| | | | | |*| | | | | |
|*| | | | |*|*|*|*|*|*| |*|*|*| | | |*| | |*|*|*|*|*|*| |*|*| | | |*| | | | | | |*| | | | | |*|*|*| |
| | | | | | |*| | | | | |*| |*| | | |*| | | | | |*| | | | | | | | | | |*|*|*|*| |*|*| |*| | | |*| | |
| |*| |*| |*|*| |*|*|*|*|*|*| |*| |*| |*|*|*| | | | | | | | | | | |*| | | | |*| | | | | | |*| | | |*|
|*| | | | | | |*|*|*|*| |*| | |*| |*| | | | | |*| | | |*| | |*|*| | | |*| | | | |*|*|*|*| |*| | |*| |
| |*| | | |*| | | | | |*| | | |*| | | | | | |*|*| | | |*|*|*| | |*|*| | | | |*|*| | | | | | | |*| |*|
| |*| | | | | | | |*| |*| |*| | |*| | |*| |*| | | |*|*| | |*| |*| | | | | | | |*|*|*| | | |*| | | |*|
| | | | |*|*| | | | | |*| |*|*| |*| |*| |*| |*| | | | |*| |*| | | |*| |*| | | |*| | | | | |*| | | |*|
| | | |*| |*| |*| | | | | | |*| | |*| |*|*| |*| |*|*|*|*| | | |*| |*| | | |*|*| |*|*| | |*|*| | |*| |
| |*|*|*| | | |*| | | |*| | |*| | |*| | | |*| |*| | | | |*| | |*| |*| |*| | | | | |*| | | |*| | | | |
| |*| | | | |*| |*|*| | | | |*|*| |*| |*| | |*| | |*| | |*| |*| | |*| | | |*| |*| |*| |*| | | | | | |
|*|*| |*| | | | |*|*|*|*|*| | | | | | | | | | |*| |*|*| | | |*|*| |*| |*| |*| |*| |*| | | | | | |*| |
| | | | |*| |*|*|*|*| | |*| | | | | |*| | | | |*| | | | | |*| |*| | | |*| | | |*|*| | | |*| | | |*| |
| | | |*| |*| |*| |*|*| | | | | | | | | | | | | |*| | |*|*| | |*| |*| | | |*| | | | | | | | | | |*|*|
| | | | | | | | | |*| | |*| |*|*| |*| | | | | |*| | | | | | |*| | | | |*| | | | | |*| | | |*|*|*| | |
|*| | | |*| |*| | | | | | | | |*| | | | |*| | |*|*|*| |*| | | |*|*|*| |*| |*| | | | | |*|*| |*| | | |
| |*| |*|*| |*| |*|*|*| |*| |*|*| |*|*| |*|*| | | |*| | | | | | |*| | |*| | | | | | | | | | |*| | | |
|*|*| | | | | | | | | |*| | | | | | |*| | | | |*| | |*| | | | |*| | |*| | |*|*|*|*| |*|*|*| | |*|*| |
| |*| | | | | | |*|*|*| |*|*|*|*|*| | |*|*|*| | |*| |*| | | | | |*| | | | | | | |*| | | | |*|*|*| | |
|*| |*| | |*| | | |*|*| | | | | |*| |*| | | | |*| | |*| | | |*| | |*| |*|*| |*| | | |*| | | | |*| |*|
|*| |*|*| | | |*| |*| | | | |*|*| | | | |*| | |*| | |*| |*|*| | | |*| | | | |*|*|*|*| |*|*| |*| | |*|
| | | | | | | | | | | | |*| | | |*| |*| |*| | |*| | |*| | |*| |*| |*|*|*|*|*|*| | | | |*| | | | | |*|
| | | | | | |*|*|*| | |*| | | | |*|*| | | | |*|*| |*|*|*| |*| |*| | |*| |*| | | | | |*| |*| | |*|*| |
| | | | | | |*|*|*| |*| | |*| | |*|*|*| | |*| | | | |*|*| |*| |*| | | |*|*| |*|*| |*|*| |*| |*| | | |
| |*| | |*| | | | |*| | |*| |*| |*| |*| | | | |*|*| |*| |*| | |*| |*| | | | |*|*| |*|*| | |*| |*| | |
|*| |*| |*| |*| |*|*| |*| | | | | | |*| |*| | | | | | | |*|*|*|*| |*|*|*|*| | |*|*| |*|*| |*|*|*|*|*|
|*|*| |*| | | | | | | | | | | | |*| | | |*|*|*| | | | |*|*|*| | |*| | | | | |*| |*|*| | |*| |*| |*| |
| |*| | |*|*|*| |*|*|*|*| | |*| | | |*| |*| |*| | | | | | |*|*|*|*|*| |*| |*|*|*| | |*| |*| | | |*| |
| |*| | | | |*|*| | | |*| | | |*| | | | |*|*| |*| |*| |*| | |*|*| | | |*|*| | | | | |*| | | | | | |*|
|*|*| | | | | | | | | | | |*| |*| | | | | | | |*| | |*|*| |*|*| | |*| | | | | | |*| | | | | |*|*| |*|
|*| | |*| |*| |*|*|*| | | | |*| |*| |*|*| |*|*|*| | | | | | | |*|*| |*| |*| | | | | | | | | |*| | |*|
| | | | | |*|*|*| | | | |*| | |*|*|*|*| | |*| | |*| | |*| | |*| | | | | | | | | | | | | | | | |*|*|*|
|*| | |*|*| | | | | |*|*| | | |*|*| | | |*|*| |*| |*|*| | | |*| | |*|*| | | |*| | | | | | | |*| | |*|
|*| |*| | | | |*| | |*| | |*| | | | | | | |*| |*| |*| |*|*| |*| | | | | |*| | | | |*|*| | |*|*| | |*|
|*| |*| | | |*| | | | | |*| | | | | | |*| | | |*|*| | |*|*| |*| | | | | | | |*| | |*|*| | | | |*|*|*|
| | | | | | | |*| | |*|*| | |*| | | | |*|*|*|*|*| | |*|*|*| |*|*|*|*| | | |*| |*| |*| |*|*| |*| | |*|
|*| | | |*| |*| | |*| |*|*| | | | | | |*| | | | | | | |*|*|*|*| | | | | | |*| |*|*| | |*| |*| | | |*|
| |*| |*| | | |*| |*|*| | | |*|*| | | | |*| |*|*|*| | | |*|*| | |*|*| | | | | |*| |*| |*| |*| |*| | |
| | |*| |*| | | | | |*| |*| | | | |*| | | | | | |*| | |*| |*|*|*| | | | |*|*|*|*|*| | |*| |*|*| | |*|
|*| |*| | | | |*|*|*| |*|*| | | | | |*| |*|*|*| | |*|*|*| | | | | |*| | | |*|*| | | | |*| | | | | |*|
|*|*| | | | | | | |*| | | | |*| |*| | | | | |*|*|*| |*|*| | | |*| | | |*| | |*|*| |*| | | |*|*| | |*|
|*| | |*| | | |*| |*| |*|*| | | | | |*| | | |*|*|*| | | | |*|*| | |*| | |*| | | | | |*|*|*| | | | |*|
|*| |*| | | | | | |*| | |*| |*|*| |*| | |*| | | | | | | | | | | |*|*| |*| |*|*| | |*| | | | |*|*|*|*|
|*| | | |*| |*| |*| |*| | |*| | | | |*| | |*| |*|*| | | | | | | | | |*| |*| | | |*| |*|*|*| | | | | |
| | | |*|*| | | |*| |*| | |*| |*|*|*|*|*|*| |*| |*| | | | |*|*|*| | | |*|*| |*| |*| |*| | | | | | |*|
| |*| | | | | | |*| |*| |*| | |*| | |*|*|*|*| | |*|*| | |*| | | | |*| |*| |*| | | |*| |*|*| |*|*| | |
|*|*| | |*|*|*| |*| |*| | | | |*| |*| |*| | |*|*| |*| | |*|*|*|*| |*| |*| |*| |*| |*| |*| |*|*| | |*|
| |*| | |*| |*|*| |*| | | | | | | |*| |*| |*|*| |*| | | | | | |*|*| | |*|*|*| |*|*| | | |*| | | |*|*|

