| | | | | |*| | | |*| |*|*| |*| |*| | | |*|*| | |*|*| | | |*|*|*| |*|*| |*|*|*| | | | | | | | | | | |
| | |*| | |*|*| |*|*| | | |*| | | | |*| | | |*|*| | | |*| |*|*| | | |*|*| |*| | |*| | | | |*| | | | |
| | | | |*|*|*| |*| | |*| |*| | |*| |*| |*| | | | |*| | | | | | | |*| | | | | | |*| |*| |*| |*|*| | |
| |*|*| | | | |*|*|*| | | | | | | | | | |*| | | | | | | | | | |*| |*| | |*|*| | | | |*| |*| |*| | |*|
| | | | | | |*|*| | | | |*| |*| |*| | | |*| | | | |*|*|*| | | | | | | | | | | |*|*| |*|*|*| |*| | |*|
| | | |*| | | |*| | | | |*|*| | |*| | | | | | | | | | | | | | |*|*|*|*|*|*|*|*| |*| | | |*|*|*|*| | |
|*|*|*| | |*| |*| |*|*|*|*| |*| |*| | | | | | | |*|*|*|*|*| |*|*| | | | | | | | | | |*|*| |*| | | | |
|*| | |*|*| | |*| | | |*| | |*| |*| |*| | |*| | |*| | | |*| |*| |*| | | | |*|*|*| |*|*|*|*| | | | | |
| |*| | | | | |*| |*| | | | |*| |*|*| |*| |*| |*|*| | | | |*|*|*|*|*| | | | |*| |*| |*| | | | | | | |
|*|*| | | |*| | | | | |*| |*| | | |*| |*| |*|*| | | |*| |*|*| | | |*| | |*| |*| |*|*|*| | | | | | | |
| |*| |*| | | | |*|*| |*| |*| |*|*|*| | | | |*| |*|*|*|*|*|*| | |*| |*| |*| | | |*| | | | | | | | | |
|*| | |*| |*|*|*| |*| |*| |*| | | | | |*| |*|*| | |*| | | | | |*|*| |*|*| |*| |*| | | | | | | | | | |
|*|*| |*| | | |*| | | |*| |*|*| |*|*| |*| | | | | | | | | |*|*|*| | | | | | | | | | | | | | | | | | |
| | | | |*|*| |*|*| |*| | | |*| | | |*| | | | | |*| | | | | |*| |*| | | | | | | | | | | | | | | | | |
|*| |*|*|*|*| | |*| |*| | | |*| |*| | | |*|*| |*| |*| | |*|*|*|*|*| | | | | | | | | | | | | | | | | |
|*|*| | |*|*| | |*|*|*| |*| | |*| | |*| | | | |*| | |*|*| |*|*| |*| | | | | | | | | | | | | | | | | |
| | |*| | | | | | | | |*| | | |*|*| |*| |*|*| | |*| | | | | |*| |*| | | | | | | | | | | | | | | | | |
| | |*| |*| |*|*|*|*| |*|*| | |*|*| | | | | |*| | | |*|*| | | | | | | | | | | | | | | | | | | | | | |
| |*| | | |*|*| | | |*| |*| | | | |*| | | | |*| |*|*| |*| | | | | | | | | | | | | | | | | | | | | | |
|*| |*| |*|*| | | | | |*| | | | |*|*|*| |*|*| | |*| |*|*| | | | | | | | | | | | | | | | | | | | | | |
|*|*| |*| | | |*|*|*|*| |*|*| |*|*| | | | |*|*|*| | |*|*| | | | | | | | | | | | | | | | | | | | | | |
| |*| | | |*|*|*| | |*|*| |*| | | |*| | | | | |*|*| |*| | | | | | | | | | | | | | | | | | | | | | | |
|*|*| |*| | | | |*|*| | |*| |*| |*|*| | | | | | | | | | | | | | | | | | | | | | | | | | | | | | | | |
|*| | | | |*|*| |*| | | | | |*|*|*| | |*|*| | | | | | | | | | | | | | | | | | | | | | | | | | | | | |
| | |*|*| |*| |*| |*|*|*|*|*| |*|*| | |*| | | | | | | | | | | | | | | | | | | | | | | | | | | | | | |
| | | | | | |*|*| | | | | |*| |*| | | |*| |*| | | | | | | | | | | | | | | | | | | | | | | | | | | | |
|*|*|*| |*| | | |*| |*| | | | |*| |*| | | |*|*| | | | | | | | | | | | | | | | | | | | | | | | | | | |
| | | | | |*|*|*|*|*| | | |*| | | |*| |*| |*| | | | | | | | | | | | | | | | | | | | | | | | | | | | |
|*|*|*| | | | | | |*|*| |*| |*|*| |*| |*| | |*| | | | | | | | | | | | | | | | | | | | | | | | | | | |
| | | |*| |*|*| | |*| | | | | | |*| |*| | |*| | | | | | | | | | | | | | | | | | | | | | | | | | | | |
|*| |*| | | | |*| |*| |*|*| | |*| |*|*|*| | | | | | | | | | | | | | | | | | | | | | | | | | | | | | |
|*|*| |*|*| | | | |*| | | | | |*|*| | | |*| | | | | | | | | | | | | | | | | | | | | | | | | | | | | |
| | | |*| | | | | |*| |*|*| | | |*| | | | | | | | | | | | | | | | | | | | | | | | | | | | | | | | | |
|*| |*| |*|*|*|*| |*| | | | |*| |*| | | | | | | | | | | | | | | | | | | | | | | | | | | | | | | | | |
|*| | | | | |*|*|*|*| |*| | | |*| | | | | | | | | | | | | | | | | | | | | | | | | | | | | | | | | | |
| |*|*|*|*| |*| |*| | | | |*|*| | | | | | | | | | | | | | | | | | | | | | | | | | | | | | | | | | | |
|*| | | |*| | | | | |*| |*| | | | | | | | | | | | | | | | | | | | | | | | | | | | | | | | | | | | | |
|*| | | |*| | | |*| |*| |*| | | | | | | | | | | | | | | | | | | | | | | | | | | | | | | | | | | | | |
|*| |*| |*| | |*| | | | | | | | | | | | | | | | | | | | | | | | | | | | | | | | | | | | | | | | | | |
| | | | | |*|*| |*| | | | | | | | | | | | | | | | | | | | | | | | | | | | | | | | | | | | | | | | | |
|*| | | | |*|*|*|*| | | | | | | | | | | | | | | | | | | | | | | | | | | | | | | | | | | | | | | | | |
| | |*| | |*| | | | | | | | | | | | | | | | | | | | | | | | | | | | | | | | | | | | | | | | | | | | |
| |*|*| |*|*| |*|*|*| | | | | | | | | | | | | | | | | | | | | | | | | | | | | | | | | | | | | | | | |
| | |*|*| | |*| |*|*| | | | | | | | | | | | | | | | | | | | | | | | | | | | | | | | | | | | | | | | |
| | |*|*| | | | |*| | | | | | | | | | | | | | | | | | | | | | | | | | | | | | | | | | | | | | | | | |
| |*|*|*| |*| | |*| | | | | | | | | | | | | | | | | | | | | | | | | | | | | | | | | | | | | | | | | |
| |*| |*| | |*|*| | | | | | | | | | | | | | | | | | | | | | | | | | | | | | | | | | | | | | | | | | |
|*| | | |*| |*| | | | | | | | | | | | | | | | | | | | | | | | | | | | | | | | | | | | | | | | | | | |
|*| |*| | | |*| | | | | | | | | | | | | | | | | | | | | | | | | | | | | | | | | | | | | | | | | | | |
| |*| | |*|*| | | | | | | | | | | | | | | | | | | | | | | | | | | | | | | | | | | | | | | | | | | | |

